    #############################    
    #                           #    
    #___________________________#    
    #                           #    
#####                           #####
#   |                           |   #
#   |                           |   #
#####                           #####
    #                           #    
    #                           #    
    #___________________________#    
    #                           #    
    #############################    