    ###########################    
    #                         #    
    #_________________________#    
    #                         #    
#####                         #####
#   |                         |   #
#   |                         |   #
#####                         #####
    #                         #    
    #                         #    
    #_________________________#    
    #                         #    
    ###########################    